1111111111
1000200001
1010110101
1000010101
1101000101
1000010101
1011000001
0011111101
1000000001
1111111111