1111111111
1000000001
1000000001
1000000001
1000000011
1000000001
1000000001
1000000001
1200000001
1111101111