1111111111
1000000001
1000001101
0000010101
1111000101
1000010101
1011000101
1011000001
1210000101
1111111111