1111111111
1000200001
1010110101
1000010101
1101000101
1000010101
1011000001
1011111101
1010000101
1111111101